téléphone : téléphonique :: sœur : ['sororal']
isolément : isolé :: critique : ['critique']
désolation : désolé :: matériellement : ['matériel']
paralytique : paralysie :: fond : ['profond', 'foncier']
synthétiser : synthétique :: rêver : ['onirique']
bien : bon :: blanc : ['blanc']
chien : canin :: nouveau-né : ['néonatal']
faune : faunique :: carré : ['carré']
forêt : forestier :: athlétisme : ['athlétique']
Phocée : phocéen :: éruption : ['éruptif']
adulte : adulte :: énergie : ['énergétique']
entièrement : entier :: banane : ['bananier']
profondément : profond :: proprement : ['propre']
chaussons : chaussonnier :: partie : ['partiel']
moralement : moral :: judicieusement : ['judicieux']
analogiquement : analogique :: face : ['facial']
océan : océane :: document : ['documentaire']
Australie : australien :: insulter : ['insultant']
estomac : gastrique :: étranger : ['étranger']
politiquement : politique :: individuellement : ['individuel']
catholicisme : catholique :: mensonge : ['mensonger']
ingratement : ingrat :: nombril : ['ombilical']
âne : asin :: suicidaire : ['suicidaire']
clown : clownesque :: étudiante : ['étudiant', 'estudiantin']
actuellement : actuel :: délit : ['délictueux']
obligatoirement : obligatoire :: ange : ['angélique']
Irlande : irlandais :: théatre : ['théâtral']
unité : unitaire :: paresseusement : ['paresseux']
énergétiquement : énergétique :: sinistrement : ['sinistre']
rond : rond :: animal : ['animalier', 'animal']
Québec : québécois :: orage : ['orageux']
ouvrier : ouvrier :: ouest : ['occidental']
heure : horaire :: syntaxe : ['syntaxique']
compatir : compassionnel :: voiture : ['automobile', 'auto']
épine : épineux :: voiture : ['automobile', 'auto']
politique : politique :: plus blanc que blanc : ['plus blanc que blanc']
immeuble : immobilier :: métropole : ['métropolitain']
Allemagne : germanique :: rose fuchsia : ['rose fuchsia']
insecticide : insecticide :: atomiquement : ['atomique']
rabbin : rabbinique :: territorialement : ['territorial']
impertinemment : impertinent :: saison : ['saisonnier']
sincèrement : sincère :: coopérer : ['coopératif']
allemand : allemand :: grippe : ['grippal']
pragmatique : pragmatique :: textile : ['textile']
couramment : courant :: soupçonneusement : ['soupçonneux']
virus : viral :: esprit : ['spirituel']
palais : palatal :: châtain : ['châtain']
médicament : médicamenteux :: conflit : ['conflictuel']
journaliste : journalistique :: fonction : ['fonctionnel']
fiducie : fiduciaire :: anciennement : ['ancien']
mammifères : mammalien :: rythme : ['rhytmique']
orphelin : orphelin :: supplémentairement : ['supplémentaire']
étudiante : estudiantin :: linguistique : ['linguistique']
fixement : fixe :: pieds : ['pédieux']
nombre : numérique :: port : ['portuaire']
chleuh : chleuh :: sphériquement : ['sphérique']
piano : pianistique :: isotope : ['isotopique']
compassion : compassionnel :: liquidation : ['liquidatif']
stratégie : stratégique :: voix : ['vocal']
banlieue : banlieusard :: citoyen : ['citoyen']
éducation : éducationnel :: boulangerie : ['boulanger']
écologie : écologiste :: souplement : ['souple']
touristiquement : touristique :: charcuterie : ['charcutier']
gloire : glorieux :: Espagne : ['espagnol']
pétrole : pétrolier :: précisément : ['précis']
poésie : poétique :: rouge : ['rouge']
Japon : japonais :: excentriquement : ['excentrique']
rose pivoine : rose pivoine :: maison : ['domestique']
nationalisme : nationaliste :: mécaniquement : ['mécanique']
sagement : sage :: cylindre : ['cylindrique']
chaotiquement : chaotique :: désespérer : ['désespéré']
préfet : préfectoral :: Indien : ['indien']
callipyge : callipyge :: rival : ['rival']
graisse : gras :: apéritif : ['apéritif']
parallèlement : parallèle :: vent : ['éolien']
lâchement : lâche :: pipe : ['pipier']
anglais : anglais :: pertinemment : ['pertinent']
proverbe : proverbial :: hypnotisme : ['hypnotique']
Lune : lunaire :: étrangement : ['étrange']
énumérer : énumératif :: entrepreneuriat : ['entrepreneurial']
vêtements : vestimentaire :: bien : ['bon', 'bien']
furieusement : furieux :: rage : ['rabique']
schématiquement : schématique :: faune : ['faunistique', 'faunique']
grandeur : grand :: semblablement : ['semblable']
héros : héroïque :: hippisme : ['hippique']
putsch : putschiste :: impec : ['impec', 'impeccable']
arrière : arrière :: drame : ['dramatique']
pape : apostolique :: probablement : ['probable']
chimie : chimique :: imaginer : ['imaginatif']
palais : palatial :: saintement : ['saint']
mentalement : mental :: astucieusement : ['astucieux']
lymphe : lymphatique :: solidement : ['solide']
hanches : coxal :: printemps : ['printanier']
fisc : fiscal :: citoyenne : ['citoyen']
Mexique : mexicain :: animal : ['animalier', 'animal']
symptomatiquement : symptomatique :: français : ['français']
planète : planétaire :: continûment : ['continu']
marbre : marbrier :: similairement : ['similaire']
félins : félin :: légume : ['légumier']
écolier : écolier :: écolière : ['écolier']
humanité : humanitaire :: aile : ['alaire']
protester : protestataire :: fuchsia : ['rose fuchsia', 'fuchsia']
gynécologie : gynécologique :: horizontalement : ['horizontal']
amarante : amarante :: illisiblement : ['illisible']
bouche : buccal :: Sahara : ['saharien']
science : scientifique :: exceptionnellement : ['exceptionnel']
bleu : bleu :: région : ['régional']
respectueusement : respectueux :: beige : ['beige']
paupières : palpébral :: extravagance : ['extravagant']
désert : érémitique :: fuchsia : ['rose fuchsia', 'fuchsia']
