ne plus être : mort :: barbu : ['barbu']
adoration : en :: bienheureux : ['bienheureux']
boire : alcoolo :: matière : ['matériel']
démission : démissionnaire :: précéder : ['précédent']
Franc : franc :: crue : ['en']
drogue : drogué :: frisson : ['frissonnant']
couleur : coloré :: Corée du Nord : ['nord-coréen']
putschiste : putschiste :: sueur : ['en', 'mouillé']
couvercle : muni :: extase : ['extatique']
déborder : rempli :: couardise : ['couard']
dents longues : à :: éligibilité : ['éligible']
présence : présent :: goût : ['sapide', 'à']
plantigrades : plantigrade :: organiser : ['organisateur']
nostalgie : chargé :: handicap : ['handicapé']
saint : saint :: rage : ['enragé']
grâce : gracieux :: miel : ['doucereux', 'mielleux']
hésiter : hésitant :: positif : ['positif']
problème : problématique :: nostalgie : ['plein', 'empreint', 'nostalgique', 'rempli', 'chargé', 'teinté']
déborder : plein :: tombeau : ['mort', 'défunt', 'décédé']
voyou : voyou :: vie : ['vivant', 'en']
bâtard : bâtard :: accident : ['accidenté']
respecter : respectueux :: flâner : ['flâneur']
sapidité : sapide :: décevoir : ['décevant']
disponibilité : disponible :: appartement : ['en']
nombre : nombreux :: prévenir : ['préventif']
supplier : suppliant :: excentrique : ['excentrique']
condamnée : condamné :: flegme : ['flegmatique']
protéger : protecteur :: débuts : ['débutant']
métal : en :: barbe : ['barbu']
admiration : rempli :: retard : ['retardataire']
bienheureuse : bienheureux :: évidence : ['évident']
religiosité : religieux :: fleur : ['fleuri', 'en', 'recouvert', 'couvert']
modifier : modificateur :: situation : ['situé']
protestataire : protestataire :: tombeau : ['mort', 'défunt', 'décédé']
ruine : ruiné :: goût de bouchon : ['bouchonné']
flocons : en :: dangerosité : ['dangereux']
rampant : rampant :: gravier : ['graveleux']
mal-aimé : mal-aimé :: force : ['fort']
désirer : désireux :: paralysé : ['paralytique']
nostalgie : empreint :: dent : ['dentelé', 'à', 'denté', 'muni']
coup dans le nez : saoul :: extrême : ['extrême']
mécontentement : mécontent :: collaboration : ['collaborateur']
ovale : ovale :: admiration : ['plein', 'en', 'admiratif', 'soulevé', 'rempli', 'transporté']
déprimer : déprimé :: le couteau sous la gorge : ['menacé']
pâleur : pâle :: inspirer : ['inspirateur']
construire : constructeur :: étourdissement : ['étourdi']
Sud-Coréen : sud-coréen :: étourderie : ['étourdi']
perturber : perturbateur :: tardivement : ['tardif']
majeur : majeur :: bosse : ['bossu', 'à']
tombe : mort :: déformer : ['déformant', 'déformateur']
exister : existant :: jaillir : ['jaillissant']
grimace : grimaçant :: illusoirement : ['illusoire']
maladie : touché :: envelopper : ['enveloppant']
tolérance : tolérant :: occuper : ['occupant']
admiration : admiratif :: fondre : ['fondant']
bel homme : bel homme :: songer : ['songeur']
conclusion : conclusif :: voyant : ['voyant']
stérilité : stérile :: lumière : ['lumineux']
adolescente : adolescent :: orage : ['orageux', 'traverser']
affirmer : affirmatif :: dent : ['dentelé', 'à', 'denté', 'muni']
héros : héroïque :: désespérer : ['désespéré']
affaiblir : affaiblissant :: briller : ['brillant']
singularité : singulier :: souci : ['soucieux']
gravité : grave :: affection : ['affectueux']
crainte : hanté :: dévaster : ['dévastateur']
se désoler : désolé :: aggraver : ['aggravant']
déterminer : déterminant :: bienveillance : ['bienveillant']
près : proche :: tombe : ['mort', 'défunt', 'décédé']
valet : soumis :: septième ciel : ['à']
français : francophone :: Mexique : ['mexicain']
dents : denté :: beauté : ['beau']
tombe : défunt :: urger : ['urgent']
rapidité : rapide :: fleur : ['fleuri', 'en', 'recouvert', 'couvert']
flotter : flottant :: correspondre : ['correspondant']
conversation : plongé :: grippe : ['grippé', 'malade']
tromper : trompeur :: bois : ['boisé']
mal : mauvais :: consentement : ['consentant']
métal : de :: conservateur : ['conservateur']
participer : participant :: catholicisme : ['catholique']
galoper : galopant :: maltraiter : ['maltraitant']
prudence : prudent :: ruminants : ['ruminant']
Coréenne : coréen :: se situer : ['situé']
dur : dur :: voler : ['voleur']
s’amuser : amusé :: désinteressement : ['désinteressé']
tomber : tombant :: efficacité : ['efficace']
enthousiasme : enthousiaste :: Turquie : ['turc']
hépatique : hépatique :: Sud-Coréenne : ['sud-coréen']
Gallois : gallois :: migraine : ['migraineux']
étrangeté : étrange :: tête dure : ['têtu', 'à']
bronchite : bronchiteux :: sur-mesure : ['sur mesure']
se venger : vengeur :: mineur : ['mineur']
extravagance : extravagant :: hétérosexuel : ['hétérosexuel']
Irlande : irlandais :: diriger : ['dirigeant', 'directeur']
s’appuyer : appuyé :: bon sens : ['plein']
pléthore : pléthorique :: hétérogénéité : ['hétérogène']
crainte : plein :: se résigner : ['résigné']
caractériser : caractéristique :: carie : ['carié']
méthode : méthodique :: liquidité : ['liquide']
Australie : australien :: se confronter : ['confronté']
distinction : distingué :: énormité : ['énorme']
admiration : transporté :: précision : ['précis']
bâtarde : bâtard :: de : ['relatif']
fécondité : fécond :: Espagne : ['espagnol']
distraction : distrait :: douche : ['sous', 'à']
possessivité : possessif :: priorité : ['prioritaire']
attention : attentif :: séduire : ['séduisant']
pigeonner : pigeonnant :: exactitude : ['exact']
admiration : soulevé :: moche : ['moche']
dominer : dominant :: ne ressembler à aucun autre : ['unique']
variété : varié :: gris : ['gris']
