subtil : subtilement :: imbécile : ['imbécilement']
hypothèse : hypothétiquement :: allusif : ['allusivement']
particulier : particulièrement :: injuste : ['injustement']
cordialité : cordialement :: justesse : ['juste']
calme : calmement :: éloigné : ['loin']
quotidien : quotidiennement :: synthétiser : ['synthétiquement']
lamentable : lamentablement :: atomique : ['atomiquement']
filial : filialement :: musculaire : ['musculairement']
éternel : éternellement :: cruel : ['cruellement']
religieux : religieusement :: proche : ['près']
morale : moralement :: juste : ['justement']
sévère : sévèrement :: explicite : ['explicitement']
brosse : en :: intellectuel : ['intellectuellement']
impec : impec :: prochain : ['prochainement']
contraire : contrairement :: bref : ['brièvement']
individu : individuellement :: respect : ['respectueusement']
lexique : lexicalement :: conscient : ['consciemment']
précoce : précocement :: géométrie : ['géométriquement']
limite : limite :: cerveau : ['cérébralement']
lent : lentement :: spécial : ['spécialement']
analogique : par :: urgent : ['urgemment']
fond : foncièrement :: instinct : ['instinctivement']
sérieux : sérieusement :: inverse : ['inversement']
homme : humainement :: fille : ['filialement']
hypocrite : hypocritement :: second : ['secondement']
tardif : tard :: cordial : ['cordialement']
nuage : en :: prioritaire : ['prioritairement']
habile : habilement :: fils : ['filialement']
nécessaire : nécessairement :: semblable : ['semblablement']
convenir : convenablement :: banal : ['banalement']
extrême : extrêmement :: objectif : ['objectivement']
pauvre : pauvrement :: diabolique : ['diaboliquement']
infini : infiniment :: honnête : ['honnêtement']
informatique : informatiquement :: difficile : ['difficilement']
pratique : pratiquement :: curieux : ['curieusement']
cinéma : cinématographiquement :: ordinaire : ['ordinairement']
supérieur : supérieurement :: sale : ['salement']
possible : possiblement :: allusion : ['allusivement']
précis : précisément :: histoire : ['historiquement']
furieux : furieusement :: hebdomadaire : ['hebdomadairement']
splendide : splendidement :: frileux : ['frileusement']
réalité : réellement :: mécanique : ['mécaniquement']
discret : discrètement :: international : ['internationalement']
parallèle : parallèlement :: vulgaire : ['vulgairement']
contredire : contradictoirement :: nuit : ['nuitamment']
miel : mielleusement :: amical : ['amicalement']
corporel : corporellement :: nature : ['naturellement']
diable : diaboliquement :: antérieur : ['antérieurement']
souterrain : souterrainement :: atroce : ['atrocement']
grammaire : grammaticalement :: politique : ['politiquement']
vêtements : vestimentairement :: indiscret : ['indiscrètement']
région : régionalement :: nombre : ['numériquement']
concept : conceptuellement :: humble : ['humblement']
excellent : excellemment :: anormal : ['anormalement']
égal : également :: étrange : ['étrangement']
correct : correctement :: courant : ['couramment']
art : artistiquement :: continuité : ['continûment']
moléculaire : moléculairement :: réel : ['réellement']
scène : scéniquement :: potentiel : ['potentiellement']
généreux : généreusement :: électricité : ['électriquement']
affectueux : affectueusement :: origine : ['originellement']
profession : professionnellement :: corps : ['physiquement', 'corporellement']
simple : simplement :: chimique : ['chimiquement']
continu : continûment :: gloire : ['glorieusement']
alphabet : alphabétiquement :: innocence : ['innocemment']
contradiction : contradictoirement :: faible : ['faiblement']
après-coup : après coup :: lointain : ['loin']
pâle : pâlement :: vertical : ['verticalement']
différent : différemment :: respectueux : ['respectueusement']
rude : rudement :: schéma : ['schématiquement']
faux : faussement :: vif : ['vivement']
vaste : vastement :: extraordinaire : ['extraordinairement']
molécule : moléculairement :: initial : ['initialement']
haut : haut :: isolé : ['isolément']
saint : saintement :: électrique : ['électriquement']
héroïque : héroïquement :: partie : ['partiellement']
nuage : par :: férocité : ['férocement']
actif : activement :: normal : ['normalement']
divers : diversement :: orage : ['orageusement']
récent : récemment :: nuage : ['par', 'en', 'sous forme']
utile : utilement :: intuition : ['intuitivement']
matin : matinalement :: régulier : ['régulièrement']
définitif : définitivement :: clandestin : ['clandestinement']
sage : sagement :: assurer : ['assurément']
horizontal : horizontalement :: sacré : ['sacrément']
fier : fièrement :: identique : ['identiquement']
sourd : sourdement :: passager : ['passagèrement']
principal : principalement :: intelligent : ['intelligemment']
fidèle : fidèlement :: exprès : ['expressément']
probable : probablement :: chaotique : ['chaotiquement']
implicite : implicitement :: sincère : ['sincèrement']
analogique : analogiquement :: proverbe : ['proverbialement']
superficiel : superficiellement :: cérébral : ['cérébralement']
merveilleux : merveilleusement :: prompt : ['promptement']
énergie : énergiquement :: étroit : ['étroitement']
hygiénique : hygiéniquement :: apparence : ['en']
apparent : en apparence :: voix : ['vocalement']
général : généralement :: sexe : ['sexuellement']
excepter : exceptionnellement :: commerce : ['commercialement']
agile : agilement :: pudique : ['pudiquement']
malhonnête : malhonnêtement :: pertinent : ['pertinemment']
clandestinité : clandestinement :: interrogatif : ['interrogativement']
commercial : commercialement :: philosophie : ['philosophiquement']
secret : secrètement :: formidable : ['formidablement']
savant : savamment :: musique : ['musicalement']
maladroit : maladroitement :: physique : ['physiquement']
anarchie : anarchiquement :: manuel : ['manuellement']
torrent : torrentiellement :: conceptuel : ['conceptuellement']
valable : valablement :: effectif : ['effectivement']
humain : humainement :: instant : ['instantanément']
