chaussure : ouvrière :: changement chimique : ['substance']
analyser : analyseur :: assurance : ['assureur']
rêve : rêveur :: Pays-Bas : ['Pays-Bas']
entraîner : entraîneur :: crépuscule : ['jour', 'journée']
de grand chemin : voleur :: nettoyer : ['nettoyeuse', 'nettoyeur', 'nettoyant']
commérage : bavard :: parier : ['parieur', 'parieuse']
réaction : réactant :: relire : ['lecteur', 'lectrice']
olivier : olive :: rock : ['rockeuse', 'rocker']
chèque : émettrice :: clapier : ['lapin']
avertir : avertisseur :: adoptif : ['adoptée', 'adoptante', 'adopté', 'adoptant']
Australie : Australie :: phobie : ['phobique']
voter : votant :: analyse : ['mathématicienne', 'mathématicien']
rabbinat : rabbin :: patiner : ['patineuse', 'patineur']
musique : auditeur :: trier : ['trieur', 'trieuse']
site : internaute :: doigt : ['gants']
boulimie : boulimique :: dominer : ['dominateur', 'dominatrice']
ciel : Dieu :: Enfer : ['diablesse', 'diable']
manège : cheval :: entêtement : ['entêté', 'entêtée']
alcoolisme : alcoolo :: lac : ['humeurs', 'mucus', 'lymphe', 'bile', 'contenu', 'sang', 'larme', 'liquide']
police : policière :: aboyer : ['chien', 'chienne']
interpeler : policière :: expérience : ['expérimentateur', 'expérimentatrice']
fleuve des morts : mort :: appartement : ['occupante', 'habitant', 'occupant', 'habitante']
réverbération : lumière :: songe : ['rêveuse', 'rêveur']
visite : visite :: excentricité : ['excentricité', 'excentrique']
jambe de force : suspension :: adoptif : ['adoptée', 'adoptante', 'adopté', 'adoptant']
terre : vivant :: survivre : ['survivante', 'survivant']
voiture : conducteur :: échecs : ['joueur', 'joueuse']
mont de Vénus : femme :: habiter : ['habitant', 'habitante']
tuberculeux : tuberculeuse :: pascal : ['Pâques']
charbonnière : charbonnier :: sauver : ['sauveteur', 'sauveur', 'sauveteuse']
pompe : moteur :: garantir : ['garant', 'garante']
temps : mesure :: lac : ['humeurs', 'mucus', 'lymphe', 'bile', 'contenu', 'sang', 'larme', 'liquide']
bourlinguer : bourlingueuse :: posséder : ['propriétaire', 'possesseur']
exécuter : exécuteur :: fleuve des Enfers : ['mort']
chipoteur : chipoteur :: fonder : ['fondateur', 'fondatrice']
patte d’éléphant : jambes :: plage : ['CD', 'album', 'disque', 'disquette']
enculer : enculeur :: théâtre : ['troupe']
chien de chasse : chasseresse :: occuper : ['occupation', 'occupant']
fume-cigare : fumeur :: tombeau : ['mort', 'macchabée', 'corps', 'morte', 'cadavre', 'squelette', 'macchab']
apprentissage : apprentie :: épidémie : ['maladie']
pays : pays :: force : ['fort']
Allemagne : Allemagne :: automobile : ['ouvrier', 'ouvrière']
agriculture : agricultrice :: camionnette : ['conductrice', 'chauffeur', 'conducteur']
interview : intervieweuse :: récoltant : ['récoltant', 'récoltante']
France : France :: armée : ['militaire']
automobile : ouvrière :: créer : ['créateur', 'créatrice']
s’évader : évadée :: résidant : ['résidant', 'résidante']
lice : chasseresse :: affirmer : ['affirmateur']
supplier : suppliante :: résidant : ['résidant', 'résidante']
apprendre : apprenante :: végétarisme : ['végétarien', 'végétarienne']
marcher : randonneuse :: adoptable : ['adoptée', 'adopté']
ionisation : molécule :: chipoteur : ['chipoteur', 'chipoteuse']
nettoyer : nettoyant :: monarchie : ['monarchiste']
bord : bateau :: déclarer : ['déclarant', 'déclarante']
enculer : enculeuse :: baignade : ['nageur', 'nageuse', 'baigneuse', 'baigneur']
se prostituer : prostituée :: crime : ['criminelle', 'auteure', 'criminel', 'auteur']
stridence : son :: abricotier : ['abricot']
chèque : auteure :: cauchemar : ['cauchemar']
mode de transport : usagère :: voie rapide : ['usagère', 'usager']
bronzette : bronzeur :: rançon : ['ravisseuse', 'ravisseur', 'kidnappeuse', 'kidnappeur']
miauler : chat :: extravagance : ['extravagant', 'extravagante']
tonneau : navire :: arracher : ['arracheur']
Fils : Dieu :: carré : ['bataillon', 'troupe']
narine : cétacé :: dictionnaire : ['lexicographe']
tousser : tousseuse :: abriter : ['abri']
salon : cliente :: développer : ['développeur', 'développeuse']
bosse : bossue :: racisme : ['raciste']
exécuter : exécutrice :: lexème : ['locutrice', 'locuteur']
flâner : flâneuse :: con : ['con']
record : recordwoman :: amont : ['cours d’eau']
priorité : priorité :: épaules : ['vêtement', 'animal']
cratère : volcan :: collaboration : ['collaborateur', 'collaboratrice', 'collabo']
percussion : percussionniste :: charbon : ['charbonnière', 'charbonnier']
riche : riche :: queue : ['parchemin', 'animal', 'oiseau']
voyageur : voyageur :: chantage : ['maître-chanteuse', 'maître-chanteur', 'auteure', 'auteur']
se venger : vengeur :: judaïsme : ['juive', 'juif']
poste : postier :: neuf : ['neuf']
lacté : blanc :: tendresse : ['tendre']
en robe des champs : pomme de terre :: science : ['savante', 'chercheur', 'scientifique', 'savant']
amandier : amande :: lac : ['humeurs', 'mucus', 'lymphe', 'bile', 'contenu', 'sang', 'larme', 'liquide']
exagérer : exagérateur :: jazz : ['jazzwoman', 'jazzman']
études : étudiant :: instrument : ['instrumentiste']
visiter : visiteuse :: organiser : ['organisateur', 'organisatrice']
rivalité : rival :: grippe : ['grippé', 'malade', 'grippée']
collaborer : collabo :: drogue : ['drogué', 'droguée']
aimer : amoureuse :: pâtisserie : ['pâtissière', 'pâtissier']
champ de fouilles : archéologue :: taule : ['taulard', 'taularde']
courriel : expéditrice :: cristal : ['matière']
science : savant :: dévorer : ['dévoreuse', 'dévoreur']
fourneau : pipe :: corps : ['récit', 'police', 'caractère', 'texte']
boucherie : boucher :: boucherie : ['bouchère', 'boucher']
adoptant : adoptant :: abandonner : ['sportive', 'sportif']
chemin de fer : usager :: écrire : ['écriveur', 'écriveuse']
orthophonie : orthophoniste :: manger : ['mangeuse', 'mangeur']
accuser : accusateur :: troupe : ['musicienne', 'soldat', 'comédien', 'musicien', 'militaire', 'comédienne']
poil dans la main : paresseux :: réalisé : ['réalisation']
caractériser : caractéristique :: drame : ['auteure', 'auteur']
tabac : chiqueur :: observer : ['observateur', 'observatrice']
bombarder : bombardier :: abeilles : ['apiculteur', 'éleveuse', 'apicultrice', 'éleveur']
longueur : nageur :: allaiter : ['nourrice', 'mère']
tombeau : macchab :: camionnette : ['conductrice', 'chauffeur', 'conducteur']
poste : postière :: briser : ['briseuse', 'briseur']
allaiter : nourrice :: record : ['recordman', 'recordwoman']
chatte : maître :: véhicule : ['conductrice', 'conducteur']
bulletin de vote : votante :: cyclisme : ['cycliste']
longueur : nageuse :: dénoncer : ['dénonciatrice', 'dénonciateur']
orgue : organiste :: gentillesse : ['gentil', 'gentille']
skis : skieuse :: mode de transport : ['usagère', 'usager']
avion : aviateur :: tige : ['plante']
adolescent : adolescent :: mammifère : ['mammifères']
