inconstant : constant :: matériel : ['spirituel']
défroncer : froncer :: pertinent : ['impertinent']
asymétrique : symétrique :: imprononçable : ['prononçable']
défavorable : favorable :: impertinent : ['pertinent']
assis : debout :: rallongement : ['raccourcissement']
jouer franc jeu : cacher son jeu :: expiré : ['inspiré']
compris : incompris :: inconsciemment : ['consciemment']
en : y :: inhabité : ['habité']
amateur : professionnel :: connaissable : ['inconnaissable']
brancher : débrancher :: inconnaissable : ['connaissable']
confortable : inconfortable :: souvent : ['jamais', 'rarement', 'quelquefois', 'parfois', 'toujours']
impardonnable : pardonnable :: sale : ['propre', 'propre', 'propre', 'propre', 'propre', 'propre', 'propre']
post- : pré- :: indiscrètement : ['discrètement']
avoir raison : avoir tort :: développer : ['envelopper']
mûr : en herbe :: forme : ['informe']
achever : commencer :: à fond : ['au ralenti', 'au pas']
discipliné : indiscipliné :: atoxique : ['toxique']
rapidement : lentement :: s’embellir : ['s’enlaidir', 'enlaidir']
commencer : finir :: inutilité : ['utilité']
rajeunir : vieillir :: négatif : ['affirmatif', 'Affirmatif', 'positif']
rien : quelque chose :: baisse : ['hausse']
inéligibilité : éligibilité :: debout : ['assis', 'couché']
expirer : courir :: inattention : ['attention']
disculper : accuser :: meuble : ['immeuble']
partir : rester :: poli : ['impoli']
désinstaller : installer :: boucher : ['déboucher']
corps simple : composé :: vendable : ['achetable']
terminer : commencer :: décoincer : ['coincer']
arrivée : départ :: malhonnêtement : ['honnêtement']
suffisamment : insuffisamment :: incohérent : ['cohérent']
desserrer : serrer :: envers : ['endroit']
inaccessibilité : accessibilité :: pur : ['impur']
expérience : inexpérience :: se dépêcher : ['prendre son temps']
souder : dessouder :: souvent : ['jamais', 'rarement', 'quelquefois', 'parfois', 'toujours']
large : étroit :: compétence : ['incompétence']
exportation : importation :: désunir : ['unir']
matinal : vespéral :: potable : ['non potable']
petit : grand :: pire : ['meilleur']
dévisser : visser :: dételer : ['atteler']
hors service : en service :: déjà : ['jamais']
fixe : portable :: proton : ['électron']
endormi : réveillé :: souvent : ['jamais', 'rarement', 'quelquefois', 'parfois', 'toujours']
défaveur : faveur :: facultatif : ['obligatoire']
exportable : importable :: commençant : ['finissant']
sortie : entrée :: cacher son jeu : ['jouer franc jeu']
interne : externe :: inspiration : ['expiration']
vite : tard :: organiser : ['désorganiser']
vespéral : matutinal :: entrer : ['sortir', 'sortir', 'quitter']
présence : absence :: incommodité : ['commodité']
disponible : indisponible :: abouti : ['inabouti']
commode : incommode :: majeur : ['mineur', 'mineur', 'mineur']
mineure : majeure :: commodité : ['incommodité']
impossibilité : possibilité :: échouer : ['réussir', 'arriver']
casser sa pipe : naître :: efficacité : ['inefficacité']
désintéresser : intéresser :: succès : ['insuccès', 'échec']
payant : gratuit :: désarmer : ['armer']
embellir : s’enlaidir :: malheureux : ['heureux', 'heureux']
ordinaire : extraordinaire :: ne pas se faire que des ennemis : ['ne pas se faire que des amis']
consonantique : vocalique :: léger : ['lourd', 'fort', 'lourd']
vespéral : matinal :: méchanceté : ['bonté']
inconfortable : confortable :: professionnel : ['amateur']
faux : original :: facile : ['difficile']
curable : incurable :: désaccord : ['accord']
xénophobie : xénophilie :: blâmable : ['louable']
immobile : mobile :: crasseux : ['impeccable']
s’écarter : se rapprocher :: jamais : ['toujours']
pendre : dépendre :: base : ['acide']
avancer : reculer :: comme un boulet : ['comme un poisson']
synonyme : antonyme :: allumé : ['éteint', 'éteint', 'éteint']
attractif : répulsif :: singulier : ['pluriel']
accuser : disculper :: à long terme : ['à court terme']
déranger : ranger :: crédible : ['incroyable']
étroit : large :: éloigner : ['rapprocher']
décéder : naître :: discret : ['indiscret']
arrêter : continuer :: inintéressant : ['intéressant']
inauthentique : authentique :: indansable : ['dansable']
confirmer : infirmer :: à propos : ['mal à propos']
à court terme : à long terme :: rester : ['partir']
objet : sujet :: libre : ['occupé', 'occupé', 'occupé', 'occupé']
cracra : impeccable :: méchant : ['gentil']
réel : irréel :: se connecter : ['se déconnecter']
malveillant : bienveillant :: intéresser : ['désintéresser']
toxique : atoxique :: faiblesse : ['force']
délier : lier :: sauvage : ['domestique', 'domestique']
doigt : pouce :: inconfort : ['confort']
honneur : déshonneur :: irresponsabilité : ['responsabilité']
complet : incomplet :: ouvert : ['fermé', 'fermé']
pourvu : dépourvu :: augmenter : ['baisser', 'diminuer']
imprudent : prudent :: irréel : ['réel']
consciemment : inconsciemment :: bien : ['mal', 'mal', 'mal', 'mal', 'mal']
en haut : en bas :: force : ['faiblesse']
serrer : desserrer :: avoir froid : ['avoir chaud']
extra- : intra- :: nez : ['arrière']
dessouder : souder :: avoir chaud : ['avoir froid']
inexigible : exigible :: coupable : ['non-coupable', 'innocent']
débrancher : brancher :: inadmissible : ['admissible']
émergé : immergé :: ralentir : ['accélérer', 'accélérer', 'accélérer', 's’accélérer', 'accélérer']
humide : sec :: vidé : ['rempli']
antérieurement : postérieurement :: s’accélérer : ['ralentir']
cradingue : impeccable :: faveur : ['défaveur']
décrocher : raccrocher :: fertile : ['infertile']
répulsif : attractif :: faux : ['vrai', 'vrai', 'juste', 'original']
postérieurement : antérieurement :: en bas : ['en haut', 'en haut']
sortir : rentrer :: sécher : ['humidifier']
confortablement : inconfortablement :: quelque part : ['nulle part']
passé : futur :: rempli : ['vide']
désabonner : abonner :: tromper : ['détromper']
vieillissant : rajeunissant :: ralentir : ['accélérer', 'accélérer', 'accélérer', 's’accélérer', 'accélérer']
accessibilité : inaccessibilité :: dansable : ['indansable']
extérieur : dedans :: à l’intérieur : ['à l’extérieur']
