musique : chorégraphie :: sel : ['poivre']
genre : nombre :: surface : ['fond']
chèque : liquide :: quelqu’un : ['quelque chose']
corps : jambes :: intégration verticale : ['intégration horizontale']
fond : devant :: s’éteindre : ['brûler']
appartement : maison :: largeur : ['longueur']
fond : apparence :: crescendo : ['decrescendo']
droite : gauche :: maladie : ['santé']
eau : glace :: vertical : ['horizontal', 'horizontal']
bouche : gorge :: chant : ['parole']
sud : nord :: avenue : ['boulevard']
science : technologie :: bretelles : ['ceinture']
marin : terrestre :: violon : ['alto', 'violon alto']
visage : corps :: avant-hier : ['après-demain']
tonnerre : éclair :: douche : ['bain', 'baignoire']
défendre : attaquer :: musical : ['dansant']
algèbre : géométrie :: arrière-petit-fils : ['arrière-petite-fille']
directeur : moteur :: vous : ['nous']
douche : bain :: vaches grasses : ['vaches maigres']
ramper : marcher :: fenêtre : ['porte']
enfin : ensuite :: dos : ['poitrine', 'poitrine']
droit : devoir :: arriver : ['partir']
là-bas : ici :: aujourd’hui : ['hier', 'demain']
réactif : produit :: patient : ['agent']
priser : chiquer :: cuillère : ['couteau', 'fourchette']
soleil : lune :: nous : ['vous']
sexe féminin : sexe masculin :: faune : ['flore']
expliquer : comprendre :: gorge : ['nuque', 'vallée', 'plateau', 'terrasse', 'bouche', 'bouche']
pipi : caca :: maintenant : ['après', 'avant', 'plus tard']
mobile : filaire :: flore : ['faune']
Résistance : collaboration :: prédécesseur : ['successeur']
Merci : De rien :: technologie : ['science']
masculin : féminin :: tutoiement : ['vouvoiement', 'voussoiement']
carré : cercle :: esprit : ['matière', 'corps']
main droite : main gauche :: cigarette : ['cigare', 'pipe']
musique classique : variété :: cash : ['chèque']
maritime : aérien :: entrée : ['sortie', 'sortie']
feu : eau :: musique : ['bruit', 'texte', 'paroles', 'livret', 'chorégraphie']
objet : sujet :: s’allonger : ['se lever', 'se lever']
signature : en-tête :: nord : ['sud']
dictature : démocratie :: matin : ['soir']
demain : aujourd’hui :: brouillon : ['propre']
immigrer : émigrer :: dent : ['griffes']
plein : vide :: thorax : ['abdomen', 'tête', 'abdomen']
comédie : tragédie :: fond : ['haut', 'sommet', 'dessus', 'forme', 'surface', 'plafond', 'combles', 'devant', 'au premier plan', 'surface', 'apparence', 'vitesse', 'jour']
pantalon : jupe :: là : ['ailleurs', 'ci', 'ici']
forme : sémantique :: ici : ['là-bas', 'ailleurs', 'ailleurs', 'loin', 'là', 'ailleurs']
muscle : nerf :: vin blanc : ['vin rouge']
Madame : Mademoiselle :: distance : ['proximité']
géographie : histoire :: maison : ['appartement']
semaine : week-end :: équivalence : ['implication']
odorat : goût :: prochain : ['actuel']
grammaire : lexique :: maintenant : ['après', 'avant', 'plus tard']
marin : terrien :: horizontal : ['vertical', 'vertical']
dernier : premier :: seul : ['ensemble']
tu : je :: motrice : ['voiture']
émetteur : récepteur :: zapper : ['s’obstiner']
atterrir : décoller :: matière ordinaire : ['matière noire']
marcher : courir :: bâbord : ['tribord']
plage avant : plage arrière :: agricole : ['urbain']
première : dernière :: au revoir : ['bonjour']
majuscule : minuscule :: république : ['monarchie']
à droite : à gauche :: jambes : ['bras', 'tête', 'corps', 'tronc', 'corps', 'tronc', 'tête']
musique : paroles :: coût d’entrée : ['coût de sortie']
critique : public :: horizontale : ['verticale']
court sur pattes : haut sur pattes :: ange : ['démon']
eau : feu :: gauche : ['droit', 'droite', 'droit', 'droite']
pain : brioche :: qualitatif : ['quantitatif']
en-tête : pied de page :: cave : ['grenier']
minuit : midi :: main gauche : ['main droite', 'main droite', 'main droite']
qualité : quantité :: zizi : ['zézette']
corps : visage :: algébrique : ['géométrique']
filaire : mobile :: ballon rond : ['ballon ovale']
démocratie : monarchie :: version : ['thème']
vents : percussions :: personnel : ['direction', 'patronat']
musique : livret :: émigrer : ['immigrer']
moins-value : plus-value :: métro : ['R.E.R', 'R.E.R']
tête : corps :: démon : ['ange']
chaussons : chaussures :: longueur : ['largeur', 'hauteur', 'profondeur']
gorge : plateau :: matière : ['esprit', 'âme', 'forme', 'énergie']
actif : passif :: droit : ['obligation', 'devoir', 'gauche', 'gauche']
réponse : question :: gaz : ['liquide', 'solide']
tête : jambes :: sapin : ['pin']
corps : esprit :: graisse : ['muscle', 'muscles']
mer : terre :: terrien : ['marin']
zézette : zizi :: terrestre : ['aérien', 'aquatique', 'marin', 'aérien', 'maritime']
ouest : est :: blanc : ['rouge']
homologue : analogue :: tête : ['pieds', 'corps', 'jambes', 'queue', 'queue']
matière noire : matière ordinaire :: lune : ['soleil']
soir : matin :: douceur : ['acidité']
torse : membre :: de large : ['de long']
jambes : tronc :: marcher : ['ramper', 'courir']
vidéo : audio :: vouvoyer : ['tutoyer']
liquide : gaz :: analogue : ['homologue']
glace : eau :: monarchique : ['démocratique', 'républicain']
brioche : pain :: nombre : ['genre']
sorcière : fée :: droitier : ['gaucher', 'gaucher']
quelque chose : quelqu’un :: exactement : ['environ', 'près']
ton : mon :: présent : ['passé']
théorie : pratique :: parterre : ['poulailler']
nom de famille : prénom :: se lever : ['s’allonger', 'se coucher', 'se coucher', 's’allonger']
ciel : terre :: tribord : ['bâbord']
jour : fond :: verglas : ['neige']
toi : moi :: hier : ['aujourd’hui', 'demain', 'aujourd’hui', 'demain']
sans excès : avec excès :: variété : ['musique classique']
demander : répondre :: goût : ['odorat']
verticalité : horizontalité :: col : ['décolleté']
tronc : jambes :: je : ['tu']
analogie : homologie :: simple : ['double']
ciel : Enfer :: moyen : ['exceptionnel', 'extraordinaire', 'nul']
