joyeux : joie :: normal : ['normalité']
raide : raideur :: fréquent : ['fréquence']
tendre : tendresse :: immense : ['immensité']
distingué : distinction :: franc : ['franchise', 'franchise', 'franchise', 'franchise']
allotropique : allotropes :: hypocrite : ['hypocrisie']
doux : douceur :: idiot : ['idiotie']
jaloux : jalousie :: ostentatoire : ['ostentation']
ivre : coup dans le nez :: transpirant : ['transpiration']
délicat : délicatesse :: immédiat : ['immédiateté']
subtil : subtilité :: dynamique : ['dynamisme']
incomplet : incomplétude :: ivre : ['ivresse', 'coup dans le nez']
civil : civilité :: stérile : ['stérilité']
roux : rousseur :: raciste : ['racisme']
abattu : abattement :: tranquille : ['tranquilité']
sage : sagesse :: honnête : ['honnêteté', 'honnêteté']
précis : précision :: satisfait : ['satisfaction']
analogue : analogie :: heureux : ['bonheur']
humble : humilité :: permanent : ['permanence']
épais : épaisseur :: maigre : ['maigreur']
convaincu : conviction :: ingrat : ['ingratitude']
débutant : début :: vulgaire : ['vulgarité']
homosexuel : homosexualité :: fou : ['folie']
tolérant : tolérance :: débutant : ['débuts', 'début']
énorme : énormité :: correct : ['correction']
bête : bêtise :: homogène : ['homogénéité', 'homogénéité', 'homogénéité']
cordial : cordialité :: nostalgique : ['nostalgie', 'nostalgie']
soulagé : soulagement :: grand : ['grandeur']
agressif : agressivité :: important : ['importance', 'importance']
anonyme : anonymat :: féroce : ['férocité']
noble : noblesse :: réel : ['réalité']
astucieux : astuce :: banal : ['banalité']
vaste : vastitude :: fade : ['fadeur']
rouge : rougeur :: gratuit : ['gratuité']
sauvage : sauvagerie :: xénophobe : ['xénophobie']
patient : patience :: strident : ['stridence']
con : connerie :: prudent : ['prudence']
propre : propreté :: curieux : ['curiosité']
clandestin : clandestinité :: disponible : ['disponibilité']
intense : intensité :: marié : ['mariage']
pertinent : pertinence :: courageux : ['courage']
majeur : majorité :: saleté : ['sale']
indiscret : indiscrétion :: injuste : ['injustice']
nouveau : nouveauté :: originel : ['origine']
blanc : blancheur :: impatient : ['impatience']
égoïste : égoïsme :: original : ['originalité']
compliqué : complication :: divers : ['diversité']
méchant : méchanceté :: animal : ['animalité', 'animalité']
oblique : obliquité :: cruel : ['cruauté']
rapide : rapidité :: zélé : ['zèle']
objectif : objectivité :: paresseux : ['paresse']
excentré : excentricité :: parfait : ['perfection']
grossier : grossièreté :: ambigu : ['ambiguïté', 'ambiguïté']
vraisemblable : vraisemblance :: imminent : ['imminence']
créatif : créativité :: esclave : ['esclavage']
inéligible : inéligibilité :: protecteur : ['protection']
difficile : difficulté :: éternel : ['éternité']
silencieux : silence :: hésitant : ['hésitation']
facile : facilité :: supérieur : ['supériorité']
cher : cherté :: singulier : ['singularité']
agile : agilité :: accessible : ['accessibilité']
fécond : fécondité :: tyran : ['tyrannie']
traître : trahison :: étrange : ['étrangeté']
extravagant : extravagance :: craintif : ['crainte']
antérieur : antériorité :: présent : ['présence']
grave : gravité :: frais : ['fraîcheur', 'fraîcheur']
salarié : salariat :: végétarien : ['végétarisme']
aimable : amabilité :: stable : ['stabilité']
indulgent : indulgence :: solide : ['solidité', 'solidité']
rare : rareté :: violent : ['violence', 'violence', 'violence']
léger : légèreté :: absent : ['absence']
vengeur : vengeance :: chauve : ['calvitie']
voluptueux : volupté :: automatique : ['automatisme']
sévère : sévérité :: frileux : ['frilosité']
calculateur : calcul :: brillant : ['brillance']
incompréhensible : incompréhensibilité :: vieux : ['vieillesse']
constant : constance :: rude : ['rudesse']
commode : commodité :: précoce : ['précocité']
faible : faiblesse :: pessimiste : ['pessimisme']
intelligent : intelligence :: extatique : ['extase']
continu : continuité :: gourmand : ['gourmandise']
statique : statisme :: tendre : ['tendreté', 'tendresse']
fragile : fragilité :: talentueux : ['talent']
localisé : localisation :: orgueilleux : ['orgueil']
capillaire : capillarité :: bizarre : ['bizarrerie']
autonome : autonomie :: splendide : ['splendeur']
sport : sportivité :: nu : ['nudité']
bon : bonté :: pâle : ['pâleur']
sûr : certitude :: respectueux : ['respect']
impertinent : impertinence :: alcoolique : ['alcoolisme']
sensible : sensibilité :: toxique : ['toxicité']
égal : égalité :: généreux : ['générosité']
blond : blondeur :: mélancolique : ['mélancolie', 'mélancolie']
quotidien : quotidienneté :: abonné : ['abonnement']
fluvial : fluvialité :: impartial : ['impartialité']
optimiste : optimisme :: enceinte : ['grossesse']
inconscient : inconscience :: possible : ['possibilité']
mobile : mobilité :: aigre : ['aigreur', 'aigreur']
évident : évidence :: brutal : ['brutalité']
triangulaire : triangle :: charmant : ['charme']
poli : politesse :: agrammatical : ['agrammaticalité']
vif : vivacité :: uniforme : ['uniformité']
décontracté : décontraction :: gentil : ['gentillesse']
réticent : réticence :: subjectif : ['subjectivité']
débrouillard : débrouillardise :: fertile : ['fertilité']
utile : utilité :: vigoureux : ['vigueur']
souple : souplesse :: mécontent : ['mécontentement']
bénévole : bénévolat :: amusé : ['amusement']
malchanceux : malchance :: stupide : ['stupidité']
solitaire : solitude :: probable : ['probabilité']
digne : dignité :: bienheureux : ['bonheur']
