chaussure : ouvrière :: changement chimique : ['substance']
analyser : analyseur :: assurance : ['assureur']
rêve : rêveur :: conférence : ['conférencier', 'conférencière']
entraîner : entraîneur :: crépuscule : ['jour', 'journée']
de grand chemin : voleur :: nettoyer : ['nettoyeur', 'nettoyeuse', 'nettoyeur', 'nettoyeuse', 'nettoyant', 'nettoyeur']
commérage : bavard :: parier : ['parieur', 'parieuse']
réaction : réactant :: relire : ['lecteur', 'lectrice']
olivier : olive :: rock : ['rocker', 'rockeuse']
chèque : émettrice :: clapier : ['lapin']
avertir : avertisseur :: adoptif : ['adoptant', 'adoptante', 'adopté', 'adoptée']
prunier : prune :: phobie : ['phobique', 'phobique']
voter : votant :: analyse : ['mathématicien', 'mathématicienne']
rabbinat : rabbin :: patiner : ['patineur', 'patineuse']
musique : auditeur :: trier : ['trieur', 'trieuse']
site : internaute :: doigt : ['gants']
boulimie : boulimique :: dominer : ['dominateur', 'dominatrice']
ciel : Dieu :: Enfer : ['diable', 'diablesse']
manège : cheval :: entêtement : ['entêté', 'entêtée']
alcoolisme : alcoolo :: lac : ['contenu', 'liquide', 'humeurs', 'sang', 'lymphe', 'bile', 'larme', 'mucus']
police : policière :: aboyer : ['chien', 'chienne']
interpeler : policière :: expérience : ['expérimentateur', 'expérimentatrice']
fleuve des morts : mort :: appartement : ['habitant', 'habitante', 'occupant', 'occupante']
réverbération : lumière :: songe : ['rêveur', 'rêveuse']
métro : passager :: excentricité : ['excentrique', 'excentrique', 'excentricité']
jambe de force : suspension :: adoptif : ['adoptant', 'adoptante', 'adopté', 'adoptée']
terre : vivant :: survivre : ['survivant', 'survivante']
voiture : conducteur :: échecs : ['joueur', 'joueuse']
mont de Vénus : femme :: habiter : ['habitant', 'habitante']
tuberculeux : tuberculeuse :: pascal : ['Pâques']
charbonnière : charbonnier :: sauver : ['sauveteur', 'sauveteuse', 'sauveur']
pompe : moteur :: garantir : ['garant', 'garante']
temps : mesure :: lac : ['contenu', 'liquide', 'humeurs', 'sang', 'lymphe', 'bile', 'larme', 'mucus']
bourlinguer : bourlingueuse :: posséder : ['possesseur', 'propriétaire', 'propriétaire']
exécuter : exécuteur :: fleuve des Enfers : ['mort']
épouvantail : effrayer :: fonder : ['fondateur', 'fondatrice']
patte d’éléphant : jambes :: plage : ['album', 'CD', 'disque', 'disquette']
enculer : enculeur :: théâtre : ['troupe']
chien de chasse : chasseresse :: occuper : ['occupant', 'occupation']
fume-cigare : fumeur :: tombeau : ['cadavre', 'macchab', 'macchabée', 'corps', 'mort', 'morte', 'squelette']
apprentissage : apprentie :: épidémie : ['maladie']
appartement : habitante :: force : ['fort']
grève : gréviste :: automobile : ['ouvrier', 'ouvrière']
agriculture : agricultrice :: camionnette : ['chauffeur', 'conducteur', 'conductrice']
interview : intervieweuse :: ionisé : ['atome', 'molécule', 'particule']
solide : matière :: armée : ['militaire', 'militaire']
automobile : ouvrière :: créer : ['créateur', 'créatrice']
s’évader : évadée :: vaincre : ['vainqueur']
lice : chasseresse :: affirmer : ['affirmateur']
supplier : suppliante :: vaincre : ['vainqueur']
apprendre : apprenante :: végétarisme : ['végétarien', 'végétarienne']
marcher : randonneuse :: adoptable : ['adopté', 'adoptée']
ionisation : molécule :: chipoteur : ['chipoteur', 'chipoteuse', 'chipoteur', 'chipoteuse', 'chipoteur', 'chipoteuse']
nettoyer : nettoyant :: monarchie : ['monarchiste', 'monarchiste']
bord : bateau :: déclarer : ['déclarant', 'déclarante']
enculer : enculeuse :: baignade : ['baigneur', 'baigneuse', 'nageur', 'nageuse']
se prostituer : prostituée :: crime : ['auteur', 'auteure', 'criminel', 'criminelle', 'criminel', 'criminelle', 'auteure', 'auteur']
stridence : son :: abricotier : ['abricot']
chèque : auteure :: courir : ['coureur', 'coureuse', 'coureur', 'bruit', 'nouvelle', 'rumeur', 'buzz', 'coureur', 'coureuse']
mode de transport : usagère :: voie rapide : ['usager', 'usagère']
bronzette : bronzeur :: rançon : ['kidnappeur', 'kidnappeuse', 'ravisseur', 'ravisseuse']
miauler : chat :: extravagance : ['extravagant', 'extravagante']
tonneau : navire :: arracher : ['arracheur']
Fils : Dieu :: carré : ['troupe', 'bataillon']
narine : cétacé :: dictionnaire : ['lexicographe', 'lexicographe']
tousser : tousseuse :: abriter : ['abri']
salon : cliente :: développer : ['développeur', 'développeuse']
bosse : bossue :: racisme : ['raciste', 'raciste']
exécuter : exécutrice :: lexème : ['locuteur', 'locutrice']
flâner : flâneuse :: kiosque : ['kiosquier', 'kiosquière']
record : recordwoman :: amont : ['cours d’eau']
cinéma : spectateur :: épaules : ['animal', 'vêtement']
cratère : volcan :: collaboration : ['collaborateur', 'collabo', 'collaboratrice', 'collabo', 'collaborateur', 'collabo']
percussion : percussionniste :: charbon : ['charbonnier', 'charbonnière']
antenne : télévision :: queue : ['animal', 'parchemin', 'oiseau']
importer : importateur :: chantage : ['auteur', 'auteure', 'maître-chanteur', 'maître-chanteuse']
se venger : vengeur :: judaïsme : ['juif', 'juive']
poste : postier :: affirmation : ['affirmateur']
lacté : blanc :: tendresse : ['tendre', 'tendre']
en robe des champs : pomme de terre :: science : ['scientifique', 'scientifique', 'savant', 'savante', 'chercheur']
amandier : amande :: lac : ['contenu', 'liquide', 'humeurs', 'sang', 'lymphe', 'bile', 'larme', 'mucus']
exagérer : exagérateur :: jazz : ['jazzman', 'jazzwoman']
études : étudiant :: instrument : ['instrumentiste', 'instrumentiste']
visiter : visiteuse :: organiser : ['organisateur', 'organisatrice']
rivalité : rival :: grippe : ['malade', 'malade', 'grippé', 'grippée']
collaborer : collabo :: drogue : ['drogué', 'droguée']
aimer : amoureuse :: pâtisserie : ['pâtissière', 'pâtissier']
champ de fouilles : archéologue :: taule : ['taulard', 'taularde']
courriel : expéditrice :: cristal : ['matière', 'matière']
science : savant :: dévorer : ['dévoreur', 'dévoreuse', 'dévoreur', 'dévoreuse']
fourneau : pipe :: corps : ['texte', 'récit', 'caractère', 'police']
boucherie : boucher :: boucherie : ['boucher', 'bouchère', 'boucher', 'bouchère', 'boucher', 'boucher']
yoga : yogi :: abandonner : ['sportif', 'sportive']
chemin de fer : usager :: écrire : ['écriveur', 'écriveuse']
orthophonie : orthophoniste :: manger : ['mangeur', 'mangeuse']
accuser : accusateur :: troupe : ['soldat', 'soldat', 'militaire', 'militaire', 'comédien', 'comédienne', 'musicien', 'musicienne']
poil dans la main : paresseux :: réalisé : ['réalisation']
caractériser : caractéristique :: drame : ['auteur', 'auteure']
tabac : chiqueur :: observer : ['observateur', 'observatrice']
bombarder : bombardier :: abeilles : ['éleveur', 'éleveuse', 'apiculteur', 'apicultrice']
longueur : nageur :: allaiter : ['mère', 'nourrice']
tombeau : macchab :: camionnette : ['chauffeur', 'conducteur', 'conductrice']
poste : postière :: briser : ['briseuse', 'briseur']
allaiter : nourrice :: record : ['recordman', 'recordwoman']
chatte : maître :: véhicule : ['conductrice', 'conducteur']
bulletin de vote : votante :: cyclisme : ['cycliste', 'cycliste']
longueur : nageuse :: dénoncer : ['dénonciatrice', 'dénonciateur']
orgue : organiste :: gentillesse : ['gentil', 'gentille']
skis : skieuse :: mode de transport : ['usager', 'usagère']
avion : aviateur :: tige : ['plante']
aboiement : chienne :: mammifère : ['mammifères']
