victoire : gagner :: comportemental : ['se comporter']
distinction : distinguer :: ressemblance : ['ressembler', 'ressembler']
vengeance : venger :: chute : ['chuter', 'tomber', 'chuter', 'tomber', 'tomber']
pansement : panser :: accomplissement : ['accomplir', 's’accomplir', 'accomplir', 's’accomplir']
avance : avancer :: boxe : ['boxer']
remise : remettre :: chantage : ['faire chanter']
division : se diviser :: hésitation : ['hésiter', 'hésiter']
implication : impliquer :: résidence : ['résider']
combat : combattre :: sprint : ['sprinter']
épluchage : éplucher :: débat : ['débattre', 'débattre']
affichage : afficher :: prétention : ['prétendre']
écouté : écouter :: facturation : ['facturer']
encombrement : encombrer :: levée : ['lever', 'lever']
grommellement : grommeler :: volonté : ['vouloir']
démarrage : démarrer :: secours : ['secourir']
inscription : inscrire :: arrachement : ['arracher']
punition : punir :: bilan : ['bilanter', 'bilanter']
coup de brosse à reluire : passer la brosse à reluire :: ouverture : ['ouvrir']
dépliage : déplier :: barrage : ['barrer']
réintégration : réintégrer :: débit : ['débiter']
applaudissements : applaudir :: soumission : ['se soumettre', 'soumettre']
amour : aimer :: concentration : ['concentrer', 'se concentrer', 'se concentrer']
essai : essayer :: aboutissement : ['aboutir']
privation : priver :: cause : ['causer', 'entraîner']
mesure : mesurer :: existant : ['exister']
datation : dater :: bataille : ['se battre', 'combattre']
entretien : s’entretenir :: tentative : ['tenter']
acquit : acquérir :: repassage : ['repasser']
grattage : gratter :: passage : ['passer', 'passer', 'passer', 'passer', 'passer']
décollage : se décoller :: pompage : ['pomper']
augmentation : augmenter :: triage : ['trier']
mépris : mépriser :: natatoire : ['nager']
ciment : cimenter :: récolte : ['récolter']
enfilage : enfiler :: choix : ['choisir']
recharge : recharger :: boutonnage : ['se boutonner', 'boutonner']
boitement : boiter :: rappel : ['rappeler']
élévation : ériger :: coup de foudre : ['s’éprendre']
dispute : se disputer :: méfiance : ['se méfier']
cuisson : cuire :: combat : ['combattre', 'se battre']
protestataire : protester :: obéissance : ['obéir']
signification : signifier :: révolte : ['se révolter']
sautillement : sautiller :: recommandation : ['recommander']
chuchotement : chuchoter :: substitution : ['substituer']
examen : examiner :: photocopie : ['photocopier']
trempage : tremper :: inspiration : ['inspirer', 'inspirer']
pollution : polluer :: transformation : ['transformer', 'se transformer', 'se transformer']
bousculade : bousculer :: faim : ['avoir faim', 'manger des briques à la sauce caillou']
relecture : relire :: correspondance : ['correspondre', 'correspondre']
aplatissage : aplatir :: galop : ['galoper']
maquillage : maquiller :: approvisionnement : ['approvisionner']
avalement : avaler :: rejet : ['rejeter']
rot : roter :: numérotation : ['numéroter']
prédiction : prédire :: importance : ['importer']
approche : approcher :: entraînement : ['entraîner']
désabonnement : désabonner :: félicitations : ['féliciter']
export : exporter :: naissance : ['naître', 'naître']
ajout : ajouter :: recul : ['reculer']
broiement : broyer :: bagarre : ['se bagarrer', 'se bagarrer']
culture : cultiver :: détournement : ['détourner', 'détourner']
affolement : affoler :: menacé : ['menacer', 'menacer']
onirique : rêver :: jeu : ['jouer', 'jouer']
encadrement : encadrer :: renouvellement : ['renouveler', 'renouveler', 'renouveler']
emprunteur : emprunter :: invention : ['inventer']
scandale : scandaliser :: rasage : ['raser', 'raser']
grignotage : grignoter :: utilisation : ['utiliser']
tranchage : trancher :: vibration : ['vibrer']
dégradation : se dégrader :: ignorance : ['ignorer']
stationnement : se stationner :: déchargement : ['décharger']
épuisement : s’épuiser :: taillage : ['tailler']
placement : placer :: soulignement : ['souligner']
énumération : énumérer :: effaçage : ['effacer']
entrée : entrer :: accusation : ['accuser', 'accuser']
puanteur : puer :: mise : ['mettre', 'mettre']
envoi : envoyer :: humiliation : ['humilier']
escalade : escalader :: accouchement : ['accoucher']
limitation : limiter :: redresser : ['redressement']
vente : vendre :: intervention : ['intervenir']
marche : marcher :: rupture : ['rompre', 'se rompre']
reproduction : reproduire :: plongeon : ['plonger']
assistance : assister :: tournement : ['tourner']
encerclement : encercler :: rallongement : ['rallonger']
jouissance : jouir :: gémissements : ['gémir']
klaxon : klaxonner :: réunion : ['se réunir']
urgence : urger :: gifle : ['gifler']
peine : peiner :: commencement : ['commencer']
empilage : empiler :: chipotage : ['chipoter', 'chipoter', 'chipoter', 'se chipoter']
inclination : incliner :: toux : ['tousser']
attaque : attaquer :: simplification : ['simplifier', 'simplifier']
roupillon : roupiller :: dépassement : ['dépasser']
définitionnel : définir :: songe : ['rêver']
imaginatif : imaginer :: changement : ['changer', 'changer', 'changer', 'changer']
désespoir : désespérer :: départ : ['partir', 'partir', 'partir']
décollage : décoller :: nettoyage : ['nettoyer', 'nettoyer', 'nettoyer', 'nettoyer', 'nettoyer', 'nettoyer', 'nettoyer', 'nettoyer', 'nettoyer', 'nettoyer', 'nettoyer', 'nettoyer']
sucrage : sucrer :: délivrance : ['délivrer']
condition : conditionner :: dialogue : ['dialoguer']
compassion : compatir :: description : ['décrire']
réalisation : réaliser :: dérangement : ['déranger']
désintérêt : désintéresser :: complot : ['comploter']
surveillance : surveiller :: sifflement : ['siffler']
ronflement : ronfler :: nationalisation : ['nationaliser']
balayage : balayer :: habitation : ['habiter']
saignement : saigner :: arrêt : ['arrêter', 's’arrêter', 's’arrêter', 'arrêter']
réussite : réussir :: sucement : ['sucer']
administration : administrer :: écoulement : ['s’écouler']
pilotage : piloter :: pêche : ['pêcher']
appréciation : apprécier :: imitation : ['imiter']
perçage : percer :: bouteille : ['boire', 'picoler', 'caresser la bouteille']
raccrochage : raccrocher :: couverture : ['couvrir']
signe : signifier :: survol : ['survoler']
disparition : disparaître :: contestation : ['contester']
