renoncule : plante :: poireau : ['légume']
caille-lait : plante :: vendredi : ['jour']
grenouille : amphibiens :: anniversaire : ['fête', 'évènement']
abus de biens sociaux : délit :: ours : ['bête', 'plantigrades', 'animal', 'mammifères']
monarque : insecte :: mésange nonnette : ['passereaux', 'oiseaux', 'oiseau']
chiffon : texte :: légume : ['plante']
pelle : outil :: Soleil : ['étoile', 'corps céleste', 'astre']
chat de gouttière : chat :: coiffeuse : ['métier', 'profession', 'meuble']
convertible : meuble :: gastéropodes : ['animal', 'espèce', 'famille', 'classe']
grenouille : batracien :: trottinette : ['véhicule', 'véhicule roulant', 'deux-roues', 'jouet']
lin : matériau :: belladone : ['plante']
boulangère : métier :: produit : ['substance', 'opération']
mouton : animal :: choucroute : ['aliment', 'plat']
cheval : ongulés :: blé : ['céréales']
iris : plante :: poisson rouge : ['poisson', 'poissons']
T10 : habitation :: vin de pays : ['boisson alcoolisée', 'boisson']
entrecôte : viande :: passerose : ['plante', 'fleur']
monnaie-du-pape : plante :: appareil informatique : ['appareil']
comptable : métier :: F8 : ['logement', 'habitation']
petit pain : pain :: valise : ['bagage']
football australien : sport :: noix : ['fruit']
lit : meuble :: virgule : ['signe', 'signe de ponctuation']
lac : pièce d’eau :: résistance : ['organisation']
zéphyr : vent :: aspirateur : ['appareil', 'appareil électroménager', 'logiciel']
cinq-pièces : logement :: ficelle : ['pain']
dos : nage :: doigt : ['partie du corps']
e-mail : message :: jupette : ['vêtement']
violette : plante :: fabulateur : ['menteur']
kaki : fruit :: grande boucle : ['évènement sportif', 'épreuve', 'compétition']
soie : textile :: intégration verticale : ['stratégie']
hépatiques : plante :: rêver : ['vouloir']
expert : professionnel :: mésange bleue : ['passereaux', 'oiseaux', 'oiseau']
causette : échange verbal :: pince : ['outil']
développé couché : exercice :: football américain : ['sport']
racine de bruyère : bois :: huit : ['nombre']
chemin : voie :: grenier : ['bâtiment']
société de personnes : société :: Igor : ['prénom', 'nom']
sapin : matériau :: gentiane : ['boisson alcoolisée', 'apéritif', 'plante', 'fleur', 'boisson']
vélo : cycle :: canette : ['boisson alcoolisée', 'boisson']
guitare : instrument :: mélancolie : ['sentiment', 'trouble psychique', 'maladie', 'état']
loup de mer : poissons :: peur : ['sentiment']
betterave : plante :: hongre : ['animal']
filaire : moyen de communication :: citronnier : ['arbre']
pétrel-tempête : oiseaux :: canard : ['viande', 'son', 'avion', 'oiseau']
CMPU : méthode de calcul :: entier : ['nombre']
tramway : véhicule roulant :: article : ['subdivision']
Terre : planète :: jean : ['vêtement']
mille : nombre :: populage : ['plante', 'fleur']
F1 : habitation :: cicatrice : ['lésion']
gorge-de-pigeon : coloré :: chaise à bascule : ['chaise']
rouge-queue : passereaux :: colimaçon : ['animal']
aiguisoir : outil :: avant : ['localisé']
chimiste : scientifique :: étoile d’argent : ['plante', 'fleur']
rage : comportement :: Australie : ['continent', 'pays']
anémone de mer : animal :: gnôle : ['boisson alcoolisée', 'boisson']
grippe : maladie :: politique de l’autruche : ['comportement']
Angleterre : pays :: picrate : ['boisson alcoolisée', 'boisson']
kaki : plante :: antennes : ['partie du corps', 'appendice']
chicorée : boisson chaude :: tournesol : ['plante', 'fleur']
cacao : boisson chaude :: passement : ['tissu']
Orsay : ville :: ancolie : ['plante', 'fleur']
belle-de-nuit : fleur :: répugnance : ['sentiment']
escargots : plat :: F2 : ['logement', 'habitation']
T6 : logement :: quatre-vingts : ['nombre', 'numéro']
alligator : reptiles :: sphère : ['volume']
batteur : musicien :: sous-traitance : ['opération']
antichambre : pièce :: champagne : ['boisson alcoolisée', 'vin', 'boisson', 'couleur']
crawl : nage :: astre : ['corps céleste']
paroles : texte :: tisane : ['boisson', 'boisson chaude']
fuchsia : plante :: longueur : ['mesure', 'athlétisme', 'grandeur']
jacinthe : plante :: essence : ['substance']
T7 : habitation :: formulaire : ['document']
seins : partie du corps :: serveur : ['appareil informatique']
serviette : linge :: mécanicienne : ['ouvrière']
orfèvre : artisan :: table de chevet : ['pièce d’ameublement', 'meuble']
pluie : temps :: deuxième : ['vitesse']
mai 68 : évènement historique :: hache : ['arme']
feuille de route : document :: glaïeul : ['plante', 'fleur']
bleuet : fleur :: chèvre : ['fromage', 'animal']
cent : nombre :: demi-tour : ['mouvement']
pharmacie : science :: corps pur simple : ['corps pur']
canap : meuble :: jalousie : ['sentiment']
mésange : oiseaux :: marché réglementé : ['marché']
homard : crustacés :: abricotier : ['arbre']
deux : nombre :: plaisir : ['sentiment']
800 mètres : évènement sportif :: instrument à percussion : ['instrument de musique']
cake : gâteau :: zigzag : ['déplacement', 'ligne', 'forme']
narcisse : plante :: plateau : ['compétition', 'cible', 'évènement sportif', 'surface plane', 'relief']
vinasse : boisson :: gaillet : ['plante', 'fleur']
bâtiment et travaux publics : secteur :: batraciens : ['animal', 'ordre', 'espèce', 'famille', 'classe']
pièce montée : pâtisserie :: instrument de cuisine : ['ustensile']
rabbinat : fonction :: kaki : ['vêtement', 'coloré', 'tenue', 'fruit', 'plante', 'habit', 'couleur', 'arbre']
tournevis : outil :: tortue : ['reptiles', 'animal']
F10 : logement :: catch : ['sport de combat']
requin : poissons :: vue : ['sens']
bœuf : bovin :: bouchère : ['métier', 'profession', 'marchande']
voilier : bateau :: haine : ['sentiment', 'émotion']
épée : arme blanche :: sardine : ['poisson', 'poissons']
lupin : fleur :: colibri : ['oiseaux', 'oiseau']
baraque : construction :: revolver : ['arme à feu']
bière : boisson alcoolisée :: pou : ['parasite', 'insectes', 'insecte']
infusion : boisson :: vin : ['boisson alcoolisée', 'boisson', 'secteur']
loup de mer : poisson :: volcan gris : ['volcan']
amarante : couleur :: vin blanc : ['boisson alcoolisée', 'boisson']
narines : orifice :: oxalide : ['plante', 'fleur']
torse : partie du corps :: vache : ['animal', 'viande', 'bovin', 'animal d’élevage', 'ongulés']
lésion : affection :: belle-d’un-jour : ['plante', 'fleur']
gaz naturel : combustible :: ski : ['sport d’hiver', 'sport de glisse']
karaté : sport de combat :: comédie : ['théatre', 'œuvre']
avocatier : arbre :: rose fuchsia : ['couleur', 'coloré']
