s’étouffer : étouffement :: républicain : ['république']
chatouille : chatouiller :: piqué : ['piquer']
utérin : utérus :: s’entretenir : ['entretien']
costal : côte :: écologiste : ['écologie']
documentaire : document :: jeter : ['jet', 'jetage']
philosophiquement : philosophie :: électrique : ['électricité']
nasal : nez :: déboucher : ['débouchage']
communiste : communisme :: reconnaître : ['reconnaissance']
lumineux : lumière :: médiatique : ['médias']
courir : course :: continental : ['continent']
asin : âne :: manger des briques à la sauce caillou : ['faim']
communal : commune :: honorer : ['honneur']
continûment : continuité :: dominer : ['domination']
dimensionnel : dimension :: ressembler : ['ressemblance']
comparativement : comparaison :: criminel : ['crime']
décaler : décalage :: tragique : ['tragédie']
canadien : Canada :: polaire : ['pôle']
orageux : orage :: jugal : ['joues']
gestuellement : geste :: élire : ['élection']
racketter : racket :: sylvestre : ['forêt']
temporal : tempe :: mammalien : ['mammifères']
agresser : agression :: auditif : ['audition', 'ouïe']
s’étirer : étirement :: téléphonique : ['téléphone']
bouillir : ébullition :: écolier : ['écolière', 'écolier']
fébrile : fièvre :: trancher : ['tranchage']
malaire : joues :: conserver : ['conservation']
angélique : ange :: stomacal : ['estomac']
pédaler : pédalage :: relire : ['relecture']
rond : rond :: français : ['français', 'France']
enrichir : enrichissement :: chatouiller : ['chatouille', 'chatouilles']
coréen : Corée :: traire : ['traite']
taire : silence :: callipyge : ['callipyge']
désintéresser : désintérêt :: expérimenter : ['expérimentation']
enlaidir : enlaidissement :: abuser : ['abus']
stationner : stationnement :: tisser : ['tissage']
bananier : banane :: dictatorial : ['dictature']
fondre : fonte :: lunaire : ['Lune', 'lune']
portuaire : port :: tricher : ['tricherie', 'triche']
contrôlant : contrôle :: débuter : ['début']
humanitaire : humanitaire :: prier : ['prière']
expérimental : expérience :: vestimentairement : ['vêtements']
se confondre : confusion :: prévenir : ['prévention']
virer : virage :: boulanger : ['boulangerie']
européen : Europe :: fiduciaire : ['fiducie']
empiler : empilage :: mnémonique : ['mémoire']
fabriquer : fabrication :: zoologique : ['zoologie']
apporter : apport :: manifester : ['manifestation']
réagir : réaction :: licencier : ['licenciement']
hurler : hurlements :: surveiller : ['surveillance']
souffler : souffle :: se renverser : ['renversement']
franchir : franchissement :: hollandais : ['Hollande', 'hollandais']
ordonner : ordre :: anarchique : ['anarchie']
fiévreux : fièvre :: piloter : ['pilotage']
expédier : expédition :: s’achever : ['achèvement']
avancement : avancer :: restructurer : ['restructuration']
barométrique : baromètre :: embrasser : ['baiser', 'embrassement']
tailler : taillage :: trébucher : ['trébuchement']
alphabétiquement : alphabet :: ombilical : ['nombril', 'ombilic']
vider : vidage :: aspirer : ['aspiration']
palatial : palais :: matinalement : ['matin']
autoroutier : autoroute :: caravanier : ['caravane']
capillaire : capillarité :: ronchonner : ['ronchonnement']
de naissance : naissance :: instinctivement : ['instinct']
félin : félins :: passer la brosse à reluire : ['coup de brosse à reluire']
compter : comptage :: tenter : ['tentative', 'tentation']
contestataire : contestation :: dérouler : ['déroulement']
thoracique : thorax :: médical : ['médecine']
pendulaire : pendule :: sororal : ['sœur']
bâiller : bâillement :: gicler : ['giclement']
opérer : opération :: chatouiller : ['chatouille', 'chatouilles']
aryténoïde : aryténoïde :: commémorer : ['commémoration']
se méfier : méfiance :: succéder : ['succession']
jaillir : jaillissement :: chuchoter : ['chuchotement', 'chuchotis']
aîné : aînesse :: venter : ['vent']
former : formation :: écologique : ['écologie']
frimer : frime :: partager : ['partage']
célébrer : célébration :: naïvement : ['naïveté']
cardiaque : cœur :: noir : ['noir']
combattre : combat :: vert : ['vert']
empoisonner : empoisonnement :: violer : ['viol', 'violation']
hépatique : foie :: obéir : ['obéissance']
exaspérer : exaspération :: visiter : ['visite']
puer : puanteur :: décoller : ['décollage']
importer : importance :: professionnellement : ['profession']
racinaire : racine :: hésiter : ['hésitation']
honnêtement : honnêteté :: évènementiel : ['évènement']
courre : courre :: gestionnaire : ['gestion']
facturer : facturation :: poursuivre : ['poursuite']
utiliser : utilisation :: humilier : ['humiliation']
géographiquement : géographie :: grelotter : ['grelottement']
historique : histoire :: mexicain : ['Mexique']
taper : tape :: éléphantin : ['éléphant']
éponger : épongeage :: exécuter : ['exécution']
renouveler : renouvellement :: admettre : ['admission']
commercer : commerce :: influencer : ['influence']
partir : départ :: illisible : ['illisibilité']
professionnel : profession :: créer : ['création']
charnel : chair :: amical : ['ami']
fessier : fesses :: rock : ['rock']
juste : justesse :: jazzy : ['jazz']
Bravo! : bravo :: jouer : ['jeu']
trahir : trahison :: se suicider : ['suicide']
gémellaire : jumeaux :: dépanner : ['dépannage']
ronger : rongement :: immobiliser : ['immobilisation']
stellaire : étoile :: rougir : ['rougissement']
se détendre : détente :: papal : ['pape']
voler : vol :: épidémique : ['épidémie']
magique : magie :: asiatique : ['Asie']
replier : repliage :: habiter : ['habitation']
mobilier : mobiler :: tonner : ['tonnerre']
